
Day,Susceptible,Infected,Cumulative Infected,Cumulative Infected Residents,Cumulative Infected Staff,Daily Infected,Daily Infected Residents,Daily Infected Staff,Incubating,Transmitting,Symptomatic,Asymptomatic,Recovered,Residents Recovered,Staff Recovered,Dead
0,197,3,2,0,2,2,0,2,3,0,0,0,0,0,0,0
1,197,3,2,0,2,0,0,0,3,0,0,0,0,0,0,0
2,197,3,2,0,2,0,0,0,2,1,0,0,0,0,0,0
3,197,3,2,0,2,0,0,0,1,2,0,0,0,0,0,0
4,196,4,3,1,2,1,1,0,1,3,0,1,0,0,0,0
5,196,4,3,1,2,0,0,0,1,3,0,2,0,0,0,0
6,196,4,3,1,2,0,0,0,1,3,1,2,0,0,0,0
7,194,6,5,3,2,2,2,0,3,3,1,2,0,0,0,0
8,194,6,5,3,2,0,0,0,2,4,1,2,0,0,0,0
9,193,7,6,4,2,1,1,0,2,5,1,2,0,0,0,0
10,191,9,8,5,3,2,1,1,3,6,2,2,0,0,0,0
11,190,10,9,6,3,1,1,0,4,6,3,2,0,0,0,0
12,187,11,11,8,3,2,2,0,4,7,4,1,1,0,1,1
13,188,10,11,8,3,0,0,0,3,7,4,0,2,0,2,1
14,187,10,12,8,4,1,0,1,3,7,5,0,3,0,3,1
15,186,11,13,8,5,1,0,1,2,9,6,0,3,0,3,1
16,186,11,13,8,5,0,0,0,2,9,7,0,3,0,3,1
17,185,12,14,8,6,1,0,1,3,9,9,0,3,0,3,1
18,183,12,16,8,8,2,0,2,3,9,7,0,4,1,3,2
19,184,12,16,8,8,0,0,0,3,9,7,0,4,1,3,2
20,184,10,16,8,8,0,0,0,2,8,7,0,5,2,3,3
21,184,11,17,8,9,1,0,1,2,9,7,0,5,2,3,3
22,182,11,19,9,10,2,1,1,3,8,6,0,7,4,3,3
23,182,10,19,9,10,0,0,0,2,8,6,0,8,5,3,3
24,181,10,20,9,11,1,0,1,3,7,5,1,9,5,4,3
25,179,11,22,9,13,2,0,2,5,6,4,2,10,6,4,3
26,178,11,22,9,13,0,0,0,3,8,4,2,10,6,4,4
27,177,12,23,10,13,1,1,0,2,10,4,2,10,6,4,5
28,177,11,24,10,14,1,0,1,2,9,3,3,12,6,6,5
29,176,12,25,11,14,1,1,0,3,9,4,4,12,6,6,5
30,175,12,26,12,14,1,1,0,2,10,3,5,13,6,7,5
31,173,13,28,14,14,2,2,0,3,10,2,5,14,6,8,5
32,173,11,28,14,14,0,0,0,3,8,2,5,15,6,9,6
33,174,10,28,14,14,0,0,0,2,8,3,4,16,6,10,6
34,174,10,28,14,14,0,0,0,1,9,3,4,16,6,10,6
35,173,11,29,14,15,1,0,1,1,10,4,4,16,6,10,6
36,171,12,31,15,16,2,1,1,3,9,4,4,17,6,11,6
37,170,11,32,15,17,1,0,1,3,8,4,3,19,6,13,6
38,170,10,32,15,17,0,0,0,3,7,4,2,20,6,14,6
39,167,13,35,16,19,3,1,2,4,9,5,2,20,6,14,6
40,165,13,37,17,20,2,1,1,5,8,4,1,22,7,15,6
41,165,12,37,17,20,0,0,0,4,8,5,1,23,8,15,6
42,165,12,37,17,20,0,0,0,0,12,6,1,23,8,15,6
43,164,12,38,17,21,1,0,1,1,11,6,1,24,9,15,6
44,161,14,41,19,22,3,2,1,4,10,8,2,25,10,15,6
45,159,15,43,19,24,2,0,2,6,9,7,2,26,11,15,7
46,158,17,45,20,25,2,1,1,7,10,7,2,26,11,15,8
47,157,18,47,22,25,2,2,0,8,10,6,2,27,11,16,8
48,157,18,47,22,25,0,0,0,3,15,6,3,27,11,16,8
49,155,18,49,23,26,2,1,1,4,14,5,3,29,11,18,8
50,152,20,52,24,28,3,1,2,7,13,6,6,30,12,18,8
51,151,20,53,25,28,1,1,0,6,14,6,6,31,13,18,9
52,152,16,53,25,28,0,0,0,4,12,4,4,35,14,21,9
53,151,17,54,26,28,1,1,0,4,13,6,4,35,14,21,9
54,150,18,55,27,28,1,1,0,2,16,8,4,35,14,21,9
55,148,20,57,28,29,2,1,1,4,16,9,4,35,14,21,9
56,145,21,60,30,30,3,2,1,7,14,10,4,36,14,22,10
57,146,19,60,30,30,0,0,0,6,13,8,4,37,15,22,11
58,146,14,60,30,30,0,0,0,4,10,6,1,42,16,26,12
59,144,16,62,31,31,2,1,1,3,13,7,1,42,16,26,13
60,142,19,65,33,32,3,2,1,5,14,8,2,42,16,26,13
61,141,18,66,33,33,1,0,1,6,12,8,3,44,18,26,13
62,139,16,67,33,34,1,0,1,4,12,5,4,46,19,27,15
63,141,16,67,33,34,0,0,0,2,14,5,4,46,19,27,15
64,140,14,68,33,35,1,0,1,3,11,6,3,49,20,29,15
65,140,13,68,33,35,0,0,0,1,12,7,3,49,20,29,16
66,141,13,68,33,35,0,0,0,1,12,7,3,49,20,29,16
67,140,13,69,33,36,1,0,1,2,11,6,5,50,21,29,16
68,140,12,69,33,36,0,0,0,1,11,6,4,51,22,29,16
69,140,10,69,33,36,0,0,0,1,9,5,3,53,23,30,16
70,139,9,70,34,36,1,1,0,1,8,5,2,54,23,31,17
71,140,9,70,34,36,0,0,0,1,8,5,2,54,23,31,17
72,137,9,73,34,39,3,0,3,3,6,2,3,57,25,32,17
73,135,9,74,35,39,1,1,0,4,5,1,3,58,25,33,18
74,136,9,74,35,39,0,0,0,3,6,1,4,58,25,33,18
75,134,9,76,37,39,2,2,0,5,4,1,2,60,25,35,18
76,134,9,76,37,39,0,0,0,2,7,2,2,60,25,35,18
77,134,9,76,37,39,0,0,0,0,9,2,2,60,25,35,18
78,132,10,78,37,41,2,0,2,2,8,3,3,61,25,36,18
79,131,11,79,37,42,1,0,1,3,8,5,3,61,25,36,18
80,131,10,79,37,42,0,0,0,3,7,5,2,62,25,37,18
81,131,10,79,37,42,0,0,0,2,8,5,2,62,25,37,18
82,131,9,79,37,42,0,0,0,0,9,5,1,63,26,37,18
83,131,9,79,37,42,0,0,0,0,9,5,2,63,26,37,18
84,131,8,79,37,42,0,0,0,0,8,6,2,64,26,38,18
85,130,9,80,37,43,1,0,1,1,8,6,2,64,26,38,18
86,129,7,81,38,43,1,1,0,2,5,4,1,67,27,40,18
87,129,5,81,38,43,0,0,0,2,3,2,1,69,29,40,18
88,129,5,81,38,43,0,0,0,1,4,2,1,69,29,40,18
89,129,5,81,38,43,0,0,0,0,5,2,1,69,29,40,18
90,129,5,81,38,43,0,0,0,0,5,3,1,69,29,40,18
91,129,4,81,38,43,0,0,0,0,4,3,1,70,29,41,18
92,129,2,81,38,43,0,0,0,0,2,1,1,72,29,43,18
93,129,2,81,38,43,0,0,0,0,2,1,1,72,29,43,18
94,129,2,81,38,43,0,0,0,0,2,1,1,72,29,43,18
95,128,3,82,38,44,1,0,1,1,2,1,1,72,29,43,18
96,128,3,82,38,44,0,0,0,1,2,1,1,72,29,43,18
97,127,4,83,38,45,1,0,1,2,2,1,1,72,29,43,18
98,127,3,83,38,45,0,0,0,1,2,0,1,73,29,44,18
99,127,2,83,38,45,0,0,0,1,1,0,0,74,30,44,18
100,126,2,83,38,45,0,0,0,1,1,1,0,74,30,44,19
101,124,3,84,39,45,1,1,0,1,2,1,0,74,30,44,21
102,126,3,84,39,45,0,0,0,1,2,1,0,74,30,44,21
103,126,3,84,39,45,0,0,0,1,2,1,1,74,30,44,21
104,126,3,84,39,45,0,0,0,1,2,1,1,74,30,44,21
105,125,4,85,40,45,1,1,0,1,3,1,1,74,30,44,21
106,125,4,85,40,45,0,0,0,1,3,1,1,74,30,44,21
107,125,4,85,40,45,0,0,0,1,3,2,1,74,30,44,21
108,125,3,85,40,45,0,0,0,0,3,1,1,75,30,45,21
109,125,3,85,40,45,0,0,0,0,3,1,1,75,30,45,21
110,124,3,85,40,45,0,0,0,0,3,2,1,75,30,45,22
111,125,2,85,40,45,0,0,0,0,2,2,0,76,30,46,22
112,125,2,85,40,45,0,0,0,0,2,2,0,76,30,46,22
113,125,2,85,40,45,0,0,0,0,2,2,0,76,30,46,23
114,125,3,86,40,46,1,0,1,1,2,2,0,76,30,46,23
115,125,2,86,40,46,0,0,0,1,1,1,0,77,31,46,23
116,125,2,86,40,46,0,0,0,1,1,1,0,77,31,46,23
117,125,2,86,40,46,0,0,0,0,2,1,0,77,31,46,23
118,125,1,86,40,46,0,0,0,0,1,0,0,78,32,46,23
119,125,1,86,40,46,0,0,0,0,1,0,1,78,32,46,23
120,125,1,86,40,46,0,0,0,0,1,0,1,78,32,46,23
121,125,1,86,40,46,0,0,0,0,1,0,1,78,32,46,23
122,125,1,86,40,46,0,0,0,0,1,0,1,78,32,46,24
123,126,1,86,40,46,0,0,0,0,1,0,1,78,32,46,24
124,124,2,87,41,46,1,1,0,1,1,0,1,78,32,46,25
125,125,2,87,41,46,0,0,0,1,1,0,1,78,32,46,25
126,125,2,87,41,46,0,0,0,0,2,0,1,78,32,46,25
127,125,1,87,41,46,0,0,0,0,1,0,0,79,32,47,25
128,125,1,87,41,46,0,0,0,0,1,1,0,79,32,47,25
129,125,1,87,41,46,0,0,0,0,1,1,0,79,32,47,25
130,125,1,87,41,46,0,0,0,0,1,1,0,79,32,47,25
131,124,1,87,41,46,0,0,0,0,1,1,0,79,32,47,26
132,125,1,87,41,46,0,0,0,0,1,1,0,79,32,47,26
133,125,1,87,41,46,0,0,0,0,1,1,0,79,32,47,26
134,125,1,87,41,46,0,0,0,0,1,1,0,79,32,47,26
135,125,1,87,41,46,0,0,0,0,1,1,0,79,32,47,26
136,125,0,87,41,46,0,0,0,0,0,0,0,80,33,47,26
137,125,0,87,41,46,0,0,0,0,0,0,0,80,33,47,26
138,125,0,87,41,46,0,0,0,0,0,0,0,80,33,47,26
139,125,0,87,41,46,0,0,0,0,0,0,0,80,33,47,26
140,125,0,87,41,46,0,0,0,0,0,0,0,80,33,47,26
141,125,0,87,41,46,0,0,0,0,0,0,0,80,33,47,26
142,125,0,87,41,46,0,0,0,0,0,0,0,80,33,47,26
143,125,0,87,41,46,0,0,0,0,0,0,0,80,33,47,26
144,125,0,87,41,46,0,0,0,0,0,0,0,80,33,47,26
145,125,0,87,41,46,0,0,0,0,0,0,0,80,33,47,26
146,124,0,87,41,46,0,0,0,0,0,0,0,80,33,47,27
147,125,0,87,41,46,0,0,0,0,0,0,0,80,33,47,27
148,125,0,87,41,46,0,0,0,0,0,0,0,80,33,47,27
149,125,0,87,41,46,0,0,0,0,0,0,0,80,33,47,27
150,125,0,87,41,46,0,0,0,0,0,0,0,80,33,47,27
151,125,0,87,41,46,0,0,0,0,0,0,0,80,33,47,27
152,125,0,87,41,46,0,0,0,0,0,0,0,80,33,47,28
153,126,0,87,41,46,0,0,0,0,0,0,0,80,33,47,28
154,125,0,87,41,46,0,0,0,0,0,0,0,80,33,47,29
155,126,0,87,41,46,0,0,0,0,0,0,0,80,33,47,29
156,126,0,87,41,46,0,0,0,0,0,0,0,80,33,47,29
157,126,0,87,41,46,0,0,0,0,0,0,0,80,33,47,29
158,126,0,87,41,46,0,0,0,0,0,0,0,80,33,47,29
159,126,0,87,41,46,0,0,0,0,0,0,0,80,33,47,29
160,126,0,87,41,46,0,0,0,0,0,0,0,80,33,47,29
161,126,0,87,41,46,0,0,0,0,0,0,0,80,33,47,29
162,126,0,87,41,46,0,0,0,0,0,0,0,80,33,47,29
163,126,0,87,41,46,0,0,0,0,0,0,0,80,33,47,29
164,126,0,87,41,46,0,0,0,0,0,0,0,80,33,47,29
165,126,0,87,41,46,0,0,0,0,0,0,0,80,33,47,29
166,125,0,87,41,46,0,0,0,0,0,0,0,80,33,47,30
167,126,0,87,41,46,0,0,0,0,0,0,0,80,33,47,30
168,126,0,87,41,46,0,0,0,0,0,0,0,80,33,47,30
169,126,0,87,41,46,0,0,0,0,0,0,0,80,33,47,30
170,125,0,87,41,46,0,0,0,0,0,0,0,80,33,47,31
171,126,0,87,41,46,0,0,0,0,0,0,0,80,33,47,31
172,126,0,87,41,46,0,0,0,0,0,0,0,80,33,47,31
173,126,0,87,41,46,0,0,0,0,0,0,0,80,33,47,31
174,126,0,87,41,46,0,0,0,0,0,0,0,80,33,47,31
175,126,0,87,41,46,0,0,0,0,0,0,0,80,33,47,31
176,126,0,87,41,46,0,0,0,0,0,0,0,80,33,47,31
177,126,0,87,41,46,0,0,0,0,0,0,0,80,33,47,31
178,126,0,87,41,46,0,0,0,0,0,0,0,80,33,47,31
179,126,0,87,41,46,0,0,0,0,0,0,0,80,33,47,31
